     R    2000 1000
   SO texture/wall.xpm
       NO texture/wall.xpm
        EA     texture/wall.xpm
     S      texture/sprite1.xpm
    WE     texture/wall.xpm
C ,,,,,,,,,,,   100,             0      ,30
          F 100,100,100



1111111111111111111111111111111111111111
1000000000000000000000000000000000000001
1000000000000000000000000000000000000001
1000000000000000000000000000000000000001
1000000000000000000000000000000000000001
1000000000000000000000000000000000000001
1000000000000000000000000000000000000001
1000000000000000000000000000000000000001
1000000000000000000000000000000000000001
1000000000000000000000000000000000000001
1111111111111111111000000000111111111111
1002222000000000020000000000000000000001
1002202000020000200000000000000000000001
1202022000000202000000000000000000000001
1200000000000020000000000000000000000001
1200000000000000000000000000000000000001
1200000000000000000000000000000000000001
12000000S0000000000000000000000000000001
1200000000000000000000000000000000000001
1111111111111111111000000000111111111111
1000000000000000000000000000000000000001
1000000000000000000000000000000000000001
1000000000000000000000000000000000000001
1111111111111111111111111111111111111111
